11111111111111111111111111111111111111111111111111111111
10000000000000000000000000000000000000000001000000000001
10000000000000000000000000000000000000000001000000000001
10000000111110000000000000000000000000000001000000000001
10000001000001000000000001000001000000000001000000000001
10000001000000000000000001000001000000000001001111111111
10000001000000000000000001000001000000000000000000000001
10000001111111000000000001000001000000000000000000000001
10000000000000000000000001000001000000000000000000000001
11111111100000000000000001000001000000000000000000000001
10000000100000011111111110000000111111110000000000000001
10000000000000000000000000000000000000000000011100000001
10000000000000000000000000000000000000000000010100000001
10000000100000000000000000000000000000000000010100000001
11111111100000011111111100000000111111110000000000000001
10000000000000000000000010000001000000000000000000000001
10000000000000000000000010000001000000000000000000000001
100000100000000000000000100000010000000C000E000000000001
10000010000000000000000010000001000000000000000000000001
10000010000000000000000010000001000P00000000000000000001
10000010000000000000000010000001000000000000000000000001
10000010000000000000000000000000000001000010000000000001
10000010000000000000000000000000000001000010000000000001
10000010000000000000000000000000000001000010000000000001
10000010000000000000000000000000000001000010000000000001
10000010000000000000000000000000000001000010000000000001
10000010000000000000000000000000000001000010000000000001
11111111111111111111111111111111111111111111111111111111