11111111111111111111111111111111111111111111111111111111
10000000000000000000000000000000000000000001000000000001
10000000000000000000000000000000000000000001000000000001
10000000111110000000000000000000000000000001000000000001
10000001000001000000000001000001000000000001000000000001
10000001000001000000000001000001000000000001001111111111
10000001000001000000000001000001000000000000000000000001
10000000000000000000000001000001000000000000000000000001
10000000000000000000000001000001000000000000000E00000001
11111111100000000000000001000001000000000000000000000001
10000000100000011111111110000000111111110000000000000001
10000000000000000000000000000000000000000000000000000001
1000000000000000000000000000000000C000000000000000000001
10000000100000000000000000000000000000000000000000000001
111111111000000111111111000000001111111100000000C0000001
10000000000000000000000010000001000000000000000000000001
100000000000000000000000100000010000000000000000C0000001
10000010000000000000000010000001000000000000000000000001
10000010000000000000000010000001000000000000C00000000001
10000010000000000000000010000001000000000000000000000001
1000001000000000P000000010000001000000000000000000000001
10000010000000000000000000000000000001000010000000000001
10000010000000000CCC000000000000000001000010000000000001
10000010000000000000000000000000000001000010000000000001
11111111111111111111111111111111111111111111111111111111